SSSSSSSSSSSSSSSSSSSSSSSSSSSSSSSSSSS
SGGGGGGGGGGGGGGGGSGGGGGGWWGGGGGGGGS
SGGWWWWWWWWWWWWWWSWWWWWWWWGGGGGGGGS
SGGWWWWWWWWWWWWWWSWWWWWWWWGGGGGGGGS
SGGWWGEGGGGGGGGGGSGGGGGGEGGGLGGGGGS
SGGWWGGGGGGGGGGGGSGGGGGGGGGGGGGGGGS
SGGWWGGGGGGGGGGGGGGGGGGGGPGGGGGGGGS
SGGWWGGFGGGGGGGGGGGGGGGGGGGGPGGGGGS
SGBWWBGGGGGGGCGCGSGGGGGPGGGGGGGGGGS
SGBWWBGGGGGGGGGGGSGGGGGGGPGGGGGGGGS
SGGWWGGGGGGGGGCGGSGGGGGGGGGGGGGGGGS
SGGSSSSSSSSSSSSSSSSSSSSSSSSSSSSSSSS
SGGWWGGGGGGGGGGGGSGGGGGGGGGGGGGGGGG
SGGWWGGGGGGGGGGGGSGGGGGGGGGGGGGGGGG
SGGWWEGGGGGGGGGGGSGGGGGGGGGGGGGGGGG
SGGWWGGGGGGGGGGGGSGGGGGGGGGGGGGGGGG
SGGWWGGGGGGDGGRGGSGGGGGGGGGGGGGGGGG
SGGIIGGGGGGGGGGGGSGGGGGGGGGGGGGGGGG
SGGIIGGGGGGGGGGGGSGGGGGGGGGGGGGGGGG
SGGGGTGGGGGGGGGGGSGGGGGGGGGGGGGGGGG
SGGGGGGGGGGGGGGGGSGGGGGGGGGGGGGGGGG
SGGGGGGGGGGGGGGGGSGGGGGGGGGGGGGGGGG
SSSSSSSSSSSSSSSSSSGGGGGGGGGGGGGGGGG
